mild_winter = LIST {
3241 3104 3158 3224 3301 3225 3219 3099 3060 3122 2990 3020 2924 2958 2870  
2909 2982 3045 2828 2846 2726 2740 2794 2711 2811  2810 2869 2673 2699 2760    
3328 3364 3361 3432 3439 3416 3475 3506 3572 3573 3608 3546 3681 3692 3753  
3795 3822 3854 3838 3952 3963 4008 4027 3958 3999 3971 3915 3843 3817 3730 
4018 4060 4102 4178 4231 4153 4279 4329 4458 4439 4337 4406 4351 4230 4222 4133 
4091 4170 4081 4199 4152 4038 4055 3942 3983 3927 3934 3835 3914 3951#flusenland mild
3728 3815 3872 3814 3900 3941 3960 3816 3961 3989 4072 4073 3977 
4045 4067 4160 4197 4220 4295 4362 4363 4282 4404 4277 4387 4241 4131 4176  
4007 3995 4059 4089 4161 4215 4177 4125 4132 4235 4311 4242 4164 4296  
3797 3871 3760 3673 3672 3599 3594 3523 3623 3607 3536 3712 3813 3704 
3910 3982 3957 4026 4043 4006 4106 4124  4150 4094 4023 4071 4169 4044 3970  
4286 4332 4368 4306 4403 4441 4435 4376 4294 4273 4229 4377 4448 4305 4214 #shout foothils of skyreach
4024 4090 4095 4144 4157 4014 4100 4035 4101 4046 4126 4165 4221 4217 4290 
4198 4247 4287 4349 4354 4398 4350 4284 4248 4319 4300 4328 4420 4455   
4183 4216 4236 4283 4318 4312 4307 4275 4344 4380 4385 4359 4369 4370 4470   
4421 4408 4497 4554 4614 4579 4555 4559 4684 4679 4151 4672 4652 4487 4243  #flusenland
2106 2081 2073 2039 2072 2021 2076 2029 2017 1987 1977 1950 1854    
1785 1829 1927 1973 1982 1959 1841 1853 1895 1946 1800  1928 1783 
1745 1794 1752 1733 1759 1705 1690 1699 1648 1671 1680 1632 
1674 1641 1679 1623 1586 1597 1553 1566 1552 1564 1616 1654 1604 
2026 2087 1954 1919 1890 1882 1955 1998 2014 2095 2130 2160 
2138 2180 2206 2273 2218 2139 2100 2088 2015 2240 2224 2366 2325  
2259 2341 2250 2311 2278 2279 2219 2183 2149 2211 2168 2142 2213 
2289 2252 2253 2342 2364 2327 2266 2335 2284 2227 2238 2156 2207 
1857 1832 1811 1802 1956 1902 1885 1867 1999 1937 1926 1972 2020 2089 2047 2096 
5548 2194 2122 2123 2101 2111 2004 2063 2062 2066 2010 1965  2098 1497 1536 1579 1592 1601 1625 1571 1529 1578 1569 1550 1657 1653 1666 1660 1716 1750 1784 1636 1713 1775 1804 1628 1595 1551 1547 1573 2009 2065 2097 2079 2037 2008 1962 1915 1916 1963 1981 1909 1964 1788 1771 1835 1762 1836 1886 1930 1766 1803 1742 1837 1789 
2027 1952 1893 1911 1966 1892 1868 1827 1828 1845 1812  1833 1640 1689 1703 1684 1670 1719 1749 1743 1763 1665 1708 1840 1863 1876 1910 1891 1852 1887 1957 2016 1975 1799 1758 1772 1808 1720 1767 1744 1685 1782 1768 1790 1764 1704 1715 #wherenland
2584 2622 2640 2666 2641 2567 2544 2578 2501 2463 2464 2429 2753 
2404 2285 2318 2398 2355 2329 2290 2268 2243 2263 2232 2220 2368


}
normal_winter = LIST {
 5132 5154 5175 5177 5201 5213 5214 5190 5227 5226 5229 5231
 5461 5439 5437 5450 5465 5474 5449 5466 5453 5422 5426 5428  
 5435 5427 5433 5407 5389 5405 5413 5370 5325 5327 5361 5409 5367  
 5265 5289 5319 5304 5347 5336 5388 5180 5443 5415 5382 5339 5346  
 5309 5333 5326 5365 5400 5381 5371 5399 5404 5377 5351 5348 5335 
 5303 5273 5295 5356 5310 5279 5261 5235 5255 5242 5219 5197 5258 
 5208 5196 5192 5156 5131 5173 5145 5136 5111 5101 5147 5157  
 5009 5037 5058 5065 5070 5072 5082 5096 5108 5155 5141 5115 5098   
 5143 5148 5161 5166 5178 5202 5199 5221 5210 5188 5194 5181 5203  
 4958 4977 5057 5046 4988 4909 5142 5169 5184 5186 5187 5124 5107  
 4585 4668 4720 4821 4799 4874 4906 4868 4913 4773 4807 4772  
 5189 5209 5216 5215 5232 5230 5263 5293 5278 5312 5321 5315  
 5410 5397 5376 5341 5352 5384 5430 5393 5363 5305 5198 5398 5355  
 5021 5061 4948 4901 4842 4816 4885 4693 4980 4893 4839 4924 5051   
 5112 5088 5106 5149 5139 5095 5076 5038 5086 5105 5122 5140 5138  
 5350 5332 5344 5353 5379 5396 5416 5402 5364 5357 5329 5317 5318   
 5277 5296 5307 5311 5314 5308 5257 5247 5236 5195 5176 5243 5276  
 4999 4947 5094 5025 5045 5093 5085 5054 4957 5018 5000 5119 
 5290 5331 5283 5264 5245 5280 5262 5256 5240 5268 5237  
 5299 5284 5269 5251 5266 5239 5248 5249 5281 5288 5301 5254  
 4778 4841 4747 4867 4771 4748 4764 4831 4908 4935 4954 4830 5024 4882 
 5084 5100 5056 5034 5097 5079 5064 5030 5014 4953 4996 5049 5069 #navshodia normal winter
 1877 1884 1913 1905 1846 1814 1879 1967 2005 1960 1871 2051 2018 
1944 2049 2050 1897 1904 1896 1943 2040 1983 2003 2116 2085 2127 
1842 1692 1706 1727 1710 1740 1795 1849 1830 1779  
1948 2002 1883 1939 1992 2022 2043 2011 1860 1878 1938  1813 
2126 2131 2161 2135 2181 2254 2114 2182 2147 2115 2077 2067 2057  #errnorflaie normal
1331 1302 1303 1320 1278 1248 1230 1282 1266 1311 1235 1241 
1323 1367 1363 1336 1337 1270 1258 1228 1242 1257  1190 1212 1307 
1251 1231 1199 1179 1134 1123 1098 1102 1086 1059 1085  #norrfalie normal
101 103 93 104 102 105 97 111 96 
253 242 227 200 233 270 206  
142 116 152 184  148 125  133 
76 65 78 67 63 94 114 106 82  135 112    
143 181 151 188 219 248 221  169 158 
360 331 343 345 320 321  
318 308 294 264 256 288 232 217 235 310 287 290 277  273 274 249 223 239 261 231 259 237 202 203 210 317 291 282 298 299 284 258 230 224 207 240 214 255 228 #horteon normal
1778 1730 1681 1650 1709 1739 1718 1773 1801 1675 1672 1686
1614 1588 1567 1541 1580 1584 1594 1609 1621 1651 1638 1617 
1585 1622 1661 1639 1633 1602 1611 1610 1577 1559 1572 1562 1538 
1439 1461 1482 1475 1500 1506 1537 1509 1510 1490 1504 1533 1556 #errnorfalie severe
765 759 760 815 788 823 854 769 772 798 826 816 792 852 
1200 1164 1124 1127 1172 1168 1182 1109 1092 1047 1110 1039 
921 931 902 926 949 980 984 956 905 829 834 990 1008 
899 857 846 803 793 806 775 776 807 856 855 876 901 911    
903 962 1018 1009 981 927 877 835 870 843 889 913 809 858 830  
916 900 937 948 997 1017 1016 1029 1061  
878 922 1001 1002 965 906 952 968 1005 1036   
1447 1472 1434 1409 1405 1394 1423 1408 1499 1503  
1378 1407 1436 1415 1457 1460 1498 1495 1488 1458 1443 1484    
1520 1544 1480 1440 1446 1512 1487 1492 1515 1532 1481    
1545 1554 1613 1561 1587 1634 1667 1691 1738 1555 1581 1582 1521 1539  
1339 1313 1271 1214 1153 1138 1288 1254 1215 1291 1305 1262 1261   
1077 1078 1034 998 1014 1022 1051 1135 1154 1072 1037 1070 1173 
1083 1106 1113 1130 1143 1183 1160 1213 1195 1193 1174 1209 1232 
1249 1229 1201 1208 1225 1324 1346 1293 1292 1342 1317 1239 1275 
1410 1485 1505 1516 1548 1522 1508 1062 1489 1486 1448 1441 1435 1454 1419 
1267 1321 1259 1252 1326 1300 1279 1250 1347 1272 1304 1332 1349 1294  
1373 1395 1368 1387 1411 1388 1414 1365 1359 1350 1327 1298 1333 1345 1369 1374 
1335 1361 1379 1357 1383 1396 1397 1417 1402 1398 1432 1455 1437 1420   #northlands



}

severe_winter = LIST { 
191 187 238 178 160 161 211 216 262 5537 332
337 375 355 311 336 352 283 285 250 254 292
338 295 323 374 381 329 364 380 357 297
222 173 138 208 179 167 166 220 245 251 198
281 314 265 313 302 241 301 319 349
60 62 43 37 51 87 41 117 48 139 149 73
23 34 35 39 #polaris island
59 85 74 71 57 64 126 99
91 86 66 61 81 84 113
80 88 100 120 121 110 136
172 137 141 155 156 182 204 196
145 144 175 186 170 212
146 162 163 192 154  171 153 195 #northern horteon
5366 5394 5401 5434 5460 5448 5440 5419 5417 5390 5378 5349 5360
5411 5425 5420 5444 5432 5446 5458 5462 5456 5469 5476 5459 5467 5445
#shout navshodia

 }

arid = LIST {



}
